year,huc4,huc_name,count_total,count_permanent,count_seasonal,count_nowater,count_no_obs,count_huc,area_total_water,area_permanent,area_seasonal,area_nowater
1984,1401,Colorado Headwaters,231912,178710,53202,32900,42481510,42746322,208.7208,160.839,47.8818,29.61
1984,1402,Gunnison,134992,103707,31285,16677,34231573,34383242,121.4928,93.3363,28.1565,15.0093
1984,1403,Upper Colorado-Dolores,74315,43541,30774,33235,35615233,35722783,66.8835,39.1869,27.6966,29.9115
1984,1404,Great Divide-Upper Green,624642,519318,105324,83780,92536757,93245179,562.1778,467.3862,94.7916,75.402
1984,1405,White-Yampa,108011,50635,57376,43236,58191249,58342496,97.2099,45.5715,51.6384,38.9124
1984,1406,Lower Green,407892,289648,118244,74286,62869896,63352074,367.1028,260.6832,106.4196,66.8574
1984,1407,Upper Colorado-Dirty Devil,880282,797521,82761,7054,56798622,57685958,792.2538,717.7689,74.4849,6.3486
1984,1408,San Juan,327932,253974,73958,65574,103935302,104328808,295.1388,228.5766,66.5622,59.0166
1984,1501,Lower Colorado-Lake Mead,1036568,988253,48315,57272,125402502,126496342,932.9112,889.4277,43.4835,51.5448
1984,1502,Little Colorado,152491,84969,67522,116792,110775464,111044747,137.2419,76.4721,60.7698,105.1128
1984,1503,Lower Colorado,391017,360132,30885,42511,69379589,69813117,351.9153,324.1188,27.7965,38.2599
1984,1504,Upper Gila,113818,81503,32315,31805,60552854,60698477,102.4362,73.3527,29.0835,28.6245
1984,1505,Middle Gila,28329,11039,17290,55660,67002093,67086082,25.4961,9.9351,15.561,50.094
1984,1506,Salt,199989,165825,34164,97517,54389312,54686818,179.9901,149.2425,30.7476,87.7653
1984,1507,Lower Gila,26423,18808,7615,273519,60151948,60451890,23.7807,16.9272,6.8535,246.1671
1985,1401,Colorado Headwaters,200197,155568,44629,45278,42500847,42746322,180.1773,140.0112,40.1661,40.7502
1985,1402,Gunnison,116975,90153,26822,23911,34242356,34383242,105.2775,81.1377,24.1398,21.5199
1985,1403,Upper Colorado-Dolores,81625,61566,20059,26002,35615156,35722783,73.4625,55.4094,18.0531,23.4018
1985,1404,Great Divide-Upper Green,624769,504934,119835,108050,92512360,93245179,562.2921,454.4406,107.8515,97.245
1985,1405,White-Yampa,99049,51725,47324,51438,58192009,58342496,89.1441,46.5525,42.5916,46.2942
1985,1406,Lower Green,396886,290389,106497,87595,62867593,63352074,357.1974,261.3501,95.8473,78.8355
1985,1407,Upper Colorado-Dirty Devil,882372,798279,84093,5285,56798301,57685958,794.1348,718.4511,75.6837,4.7565
1985,1408,San Juan,331324,261989,69335,63466,103934018,104328808,298.1916,235.7901,62.4015,57.1194
1985,1501,Lower Colorado-Lake Mead,1053907,987503,66404,46229,125396206,126496342,948.5163,888.7527,59.7636,41.6061
1985,1502,Little Colorado,190568,88004,102564,82967,110771212,111044747,171.5112,79.2036,92.3076,74.6703
1985,1503,Lower Colorado,466693,410713,55980,41065,69305359,69813117,420.0237,369.6417,50.382,36.9585
1985,1504,Upper Gila,124167,82747,41420,21747,60552563,60698477,111.7503,74.4723,37.278,19.5723
1985,1505,Middle Gila,28594,11706,16888,54227,67003261,67086082,25.7346,10.5354,15.1992,48.8043
1985,1506,Salt,237970,174873,63097,59371,54389477,54686818,214.173,157.3857,56.7873,53.4339
1985,1507,Lower Gila,110206,17915,92291,231402,60110282,60451890,99.1854,16.1235,83.0619,208.2618
1986,1401,Colorado Headwaters,236063,175604,60459,36426,42473833,42746322,212.4567,158.0436,54.4131,32.7834
1986,1402,Gunnison,136173,94226,41947,16499,34230570,34383242,122.5557,84.8034,37.7523,14.8491
1986,1403,Upper Colorado-Dolores,98313,66255,32058,10310,35614160,35722783,88.4817,59.6295,28.8522,9.279
1986,1404,Great Divide-Upper Green,672843,498531,174312,60120,92512216,93245179,605.5587,448.6779,156.8808,54.108
1986,1405,White-Yampa,115416,53822,61594,36930,58190150,58342496,103.8744,48.4398,55.4346,33.237
1986,1406,Lower Green,420443,304685,115758,64047,62867584,63352074,378.3987,274.2165,104.1822,57.6423
1986,1407,Upper Colorado-Dirty Devil,881044,787045,93999,6592,56798322,57685958,792.9396,708.3405,84.5991,5.9328
1986,1408,San Juan,348193,245729,102464,48429,103932186,104328808,313.3737,221.1561,92.2176,43.5861
1986,1501,Lower Colorado-Lake Mead,1049700,976307,73393,50782,125395860,126496342,944.73,878.6763,66.0537,45.7038
1986,1502,Little Colorado,168535,81033,87502,106383,110769829,111044747,151.6815,72.9297,78.7518,95.7447
1986,1503,Lower Colorado,468924,404647,64277,39728,69304465,69813117,422.0316,364.1823,57.8493,35.7552
1986,1504,Upper Gila,125940,83104,42836,21677,60550860,60698477,113.346,74.7936,38.5524,19.5093
1986,1505,Middle Gila,37812,9655,28157,47451,67000819,67086082,34.0308,8.6895,25.3413,42.7059
1986,1506,Salt,241374,171490,69884,63012,54382432,54686818,217.2366,154.341,62.8956,56.7108
1986,1507,Lower Gila,28472,16118,12354,313814,60109604,60451890,25.6248,14.5062,11.1186,282.4326
1987,1401,Colorado Headwaters,228976,170520,58456,44236,42473110,42746322,206.0784,153.468,52.6104,39.8124
1987,1402,Gunnison,141267,101269,39998,11433,34230542,34383242,127.1403,91.1421,35.9982,10.2897
1987,1403,Upper Colorado-Dolores,101131,70357,30774,7422,35614230,35722783,91.0179,63.3213,27.6966,6.6798
1987,1404,Great Divide-Upper Green,627819,509628,118191,105587,92511773,93245179,565.0371,458.6652,106.3719,95.0283
1987,1405,White-Yampa,111173,51116,60057,41147,58190176,58342496,100.0557,46.0044,54.0513,37.0323
1987,1406,Lower Green,389802,292726,97076,94802,62867470,63352074,350.8218,263.4534,87.3684,85.3218
1987,1407,Upper Colorado-Dirty Devil,880883,797680,83203,6772,56798303,57685958,792.7947,717.912,74.8827,6.0948
1987,1408,San Juan,332624,239526,93098,63813,103932371,104328808,299.3616,215.5734,83.7882,57.4317
1987,1501,Lower Colorado-Lake Mead,1049641,981588,68053,50827,125395874,126496342,944.6769,883.4292,61.2477,45.7443
1987,1502,Little Colorado,200964,89567,111397,73750,110770033,111044747,180.8676,80.6103,100.2573,66.375
1987,1503,Lower Colorado,459760,393119,66641,48822,69304535,69813117,413.784,353.8071,59.9769,43.9398
1987,1504,Upper Gila,120830,79675,41155,26843,60550804,60698477,108.747,71.7075,37.0395,24.1587
1987,1505,Middle Gila,36017,9292,26725,49201,67000864,67086082,32.4153,8.3628,24.0525,44.2809
1987,1506,Salt,237494,171441,66053,66758,54382566,54686818,213.7446,154.2969,59.4477,60.0822
1987,1507,Lower Gila,22101,15193,6908,318874,60110915,60451890,19.8909,13.6737,6.2172,286.9866
1988,1401,Colorado Headwaters,231430,172020,59410,41904,42472988,42746322,208.287,154.818,53.469,37.7136
1988,1402,Gunnison,132813,95752,37061,19879,34230550,34383242,119.5317,86.1768,33.3549,17.8911
1988,1403,Upper Colorado-Dolores,98749,71307,27442,9844,35614190,35722783,88.8741,64.1763,24.6978,8.8596
1988,1404,Great Divide-Upper Green,601070,481566,119504,132607,92511502,93245179,540.963,433.4094,107.5536,119.3463
1988,1405,White-Yampa,114474,49393,65081,37872,58190150,58342496,103.0266,44.4537,58.5729,34.0848
1988,1406,Lower Green,385784,280201,105583,98829,62867461,63352074,347.2056,252.1809,95.0247,88.9461
1988,1407,Upper Colorado-Dirty Devil,872492,790945,81547,15185,56798281,57685958,785.2428,711.8505,73.3923,13.6665
1988,1408,San Juan,324373,232962,91411,72190,103932245,104328808,291.9357,209.6658,82.2699,64.971
1988,1501,Lower Colorado-Lake Mead,1045721,950797,94924,54608,125396013,126496342,941.1489,855.7173,85.4316,49.1472
1988,1502,Little Colorado,173633,86743,86890,101209,110769905,111044747,156.2697,78.0687,78.201,91.0881
1988,1503,Lower Colorado,446974,393126,53848,61242,69304901,69813117,402.2766,353.8134,48.4632,55.1178
1988,1504,Upper Gila,103271,68123,35148,44195,60551011,60698477,92.9439,61.3107,31.6332,39.7755
1988,1505,Middle Gila,39798,10162,29636,45328,67000956,67086082,35.8182,9.1458,26.6724,40.7952
1988,1506,Salt,241874,175390,66484,62452,54382492,54686818,217.6866,157.851,59.8356,56.2068
1988,1507,Lower Gila,27948,17604,10344,313520,60110422,60451890,25.1532,15.8436,9.3096,282.168
1989,1401,Colorado Headwaters,215266,163103,52163,57382,42473674,42746322,193.7394,146.7927,46.9467,51.6438
1989,1402,Gunnison,134072,100639,33433,18620,34230550,34383242,120.6648,90.5751,30.0897,16.758
1989,1403,Upper Colorado-Dolores,92660,69390,23270,15959,35614164,35722783,83.394,62.451,20.943,14.3631
1989,1404,Great Divide-Upper Green,592695,486156,106539,140004,92512480,93245179,533.4255,437.5404,95.8851,126.0036
1989,1405,White-Yampa,105085,52146,52939,47152,58190259,58342496,94.5765,46.9314,47.6451,42.4368
1989,1406,Lower Green,352416,268933,83483,132043,62867615,63352074,317.1744,242.0397,75.1347,118.8387
1989,1407,Upper Colorado-Dirty Devil,828365,759162,69203,59322,56798271,57685958,745.5285,683.2458,62.2827,53.3898
1989,1408,San Juan,306933,234521,72412,89571,103932304,104328808,276.2397,211.0689,65.1708,80.6139
1989,1501,Lower Colorado-Lake Mead,1008073,904878,103195,92393,125395876,126496342,907.2657,814.3902,92.8755,83.1537
1989,1502,Little Colorado,141618,70702,70916,133216,110769913,111044747,127.4562,63.6318,63.8244,119.8944
1989,1503,Lower Colorado,437047,386477,50570,71402,69304668,69813117,393.3423,347.8293,45.513,64.2618
1989,1504,Upper Gila,88643,31229,57414,58830,60551004,60698477,79.7787,28.1061,51.6726,52.947
1989,1505,Middle Gila,32479,8842,23637,52648,67000955,67086082,29.2311,7.9578,21.2733,47.3832
1989,1506,Salt,198055,136802,61253,106137,54382626,54686818,178.2495,123.1218,55.1277,95.5233
1989,1507,Lower Gila,25955,15558,10397,315653,60110282,60451890,23.3595,14.0022,9.3573,284.0877
1990,1401,Colorado Headwaters,207630,164456,43174,64494,42474198,42746322,186.867,148.0104,38.8566,58.0446
1990,1402,Gunnison,131208,101228,29980,21403,34230631,34383242,118.0872,91.1052,26.982,19.2627
1990,1403,Upper Colorado-Dolores,86391,65848,20543,22032,35614360,35722783,77.7519,59.2632,18.4887,19.8288
1990,1404,Great Divide-Upper Green,597045,500984,96061,131829,92516305,93245179,537.3405,450.8856,86.4549,118.6461
1990,1405,White-Yampa,102024,51324,50700,45681,58194791,58342496,91.8216,46.1916,45.63,41.1129
1990,1406,Lower Green,348386,276393,71993,133959,62869729,63352074,313.5474,248.7537,64.7937,120.5631
1990,1407,Upper Colorado-Dirty Devil,742920,667020,75900,144321,56798717,57685958,668.628,600.318,68.31,129.8889
1990,1408,San Juan,286034,210160,75874,109986,103932788,104328808,257.4306,189.144,68.2866,98.9874
1990,1501,Lower Colorado-Lake Mead,980015,873814,106201,120180,125396147,126496342,882.0135,786.4326,95.5809,108.162
1990,1502,Little Colorado,113626,39250,74376,160163,110770958,111044747,102.2634,35.325,66.9384,144.1467
1990,1503,Lower Colorado,438116,385567,52549,70439,69304562,69813117,394.3044,347.0103,47.2941,63.3951
1990,1504,Upper Gila,44585,24271,20314,102649,60551243,60698477,40.1265,21.8439,18.2826,92.3841
1990,1505,Middle Gila,38634,8562,30072,46376,67001072,67086082,34.7706,7.7058,27.0648,41.7384
1990,1506,Salt,163743,119550,44193,139794,54383281,54686818,147.3687,107.595,39.7737,125.8146
1990,1507,Lower Gila,25510,14457,11053,302228,60124152,60451890,22.959,13.0113,9.9477,272.0052
1991,1401,Colorado Headwaters,224551,171934,52617,48413,42473358,42746322,202.0959,154.7406,47.3553,43.5717
1991,1402,Gunnison,142217,105381,36836,10438,34230587,34383242,127.9953,94.8429,33.1524,9.3942
1991,1403,Upper Colorado-Dolores,94199,70319,23880,14368,35614216,35722783,84.7791,63.2871,21.492,12.9312
1991,1404,Great Divide-Upper Green,659623,523208,136415,73909,92511647,93245179,593.6607,470.8872,122.7735,66.5181
1991,1405,White-Yampa,111474,58111,53363,40656,58190366,58342496,100.3266,52.2999,48.0267,36.5904
1991,1406,Lower Green,372688,276904,95784,111777,62867609,63352074,335.4192,249.2136,86.2056,100.5993
1991,1407,Upper Colorado-Dirty Devil,716374,630370,86004,171299,56798285,57685958,644.7366,567.333,77.4036,154.1691
1991,1408,San Juan,302879,221715,81164,93618,103932311,104328808,272.5911,199.5435,73.0476,84.2562
1991,1501,Lower Colorado-Lake Mead,946025,849641,96384,154320,125395997,126496342,851.4225,764.6769,86.7456,138.888
1991,1502,Little Colorado,166194,56464,109730,108614,110769939,111044747,149.5746,50.8176,98.757,97.7526
1991,1503,Lower Colorado,443854,390994,52860,64453,69304810,69813117,399.4686,351.8946,47.574,58.0077
1991,1504,Upper Gila,102339,65543,36796,45118,60551020,60698477,92.1051,58.9887,33.1164,40.6062
1991,1505,Middle Gila,38891,10120,28771,46229,67000962,67086082,35.0019,9.108,25.8939,41.6061
1991,1506,Salt,253790,168739,85051,50547,54382481,54686818,228.411,151.8651,76.5459,45.4923
1991,1507,Lower Gila,36677,18024,18653,305511,60109702,60451890,33.0093,16.2216,16.7877,274.9599
1992,1401,Colorado Headwaters,212960,170508,42452,59493,42473869,42746322,191.664,153.4572,38.2068,53.5437
1992,1402,Gunnison,135080,105593,29487,17219,34230943,34383242,121.572,95.0337,26.5383,15.4971
1992,1403,Upper Colorado-Dolores,93367,67681,25686,15130,35614286,35722783,84.0303,60.9129,23.1174,13.617
1992,1404,Great Divide-Upper Green,624981,510654,114327,108312,92511886,93245179,562.4829,459.5886,102.8943,97.4808
1992,1405,White-Yampa,107421,54308,53113,44803,58190272,58342496,96.6789,48.8772,47.8017,40.3227
1992,1406,Lower Green,346513,255329,91184,137814,62867747,63352074,311.8617,229.7961,82.0656,124.0326
1992,1407,Upper Colorado-Dirty Devil,693636,623804,69832,193825,56798497,57685958,624.2724,561.4236,62.8488,174.4425
1992,1408,San Juan,301198,226419,74779,95187,103932423,104328808,271.0782,203.7771,67.3011,85.6683
1992,1501,Lower Colorado-Lake Mead,957058,855798,101260,143220,125396064,126496342,861.3522,770.2182,91.134,128.898
1992,1502,Little Colorado,165122,69888,95234,109551,110770074,111044747,148.6098,62.8992,85.7106,98.5959
1992,1503,Lower Colorado,439585,389534,50051,69060,69304472,69813117,395.6265,350.5806,45.0459,62.154
1992,1504,Upper Gila,118459,81478,36981,29134,60550884,60698477,106.6131,73.3302,33.2829,26.2206
1992,1505,Middle Gila,41265,11447,29818,43901,67000916,67086082,37.1385,10.3023,26.8362,39.5109
1992,1506,Salt,241729,163697,78032,62491,54382598,54686818,217.5561,147.3273,70.2288,56.2419
1992,1507,Lower Gila,92896,17924,74972,249137,60109857,60451890,83.6064,16.1316,67.4748,224.2233
1993,1401,Colorado Headwaters,238946,178270,60676,34139,42473237,42746322,215.0514,160.443,54.6084,30.7251
1993,1402,Gunnison,145073,106769,38304,7569,34230600,34383242,130.5657,96.0921,34.4736,6.8121
1993,1403,Upper Colorado-Dolores,102259,69836,32423,6352,35614172,35722783,92.0331,62.8524,29.1807,5.7168
1993,1404,Great Divide-Upper Green,666874,530657,136217,65699,92512606,93245179,600.1866,477.5913,122.5953,59.1291
1993,1405,White-Yampa,123155,57374,65781,29198,58190143,58342496,110.8395,51.6366,59.2029,26.2782
1993,1406,Lower Green,391919,286423,105496,92635,62867520,63352074,352.7271,257.7807,94.9464,83.3715
1993,1407,Upper Colorado-Dirty Devil,813335,634378,178957,74363,56798260,57685958,732.0015,570.9402,161.0613,66.9267
1993,1408,San Juan,332771,229914,102857,63822,103932215,104328808,299.4939,206.9226,92.5713,57.4398
1993,1501,Lower Colorado-Lake Mead,1006232,913200,93032,94230,125395880,126496342,905.6088,821.88,83.7288,84.807
1993,1502,Little Colorado,227744,84718,143026,47173,110769830,111044747,204.9696,76.2462,128.7234,42.4557
1993,1503,Lower Colorado,462737,393105,69632,45961,69304419,69813117,416.4633,353.7945,62.6688,41.3649
1993,1504,Upper Gila,129236,79414,49822,18497,60550744,60698477,116.3124,71.4726,44.8398,16.6473
1993,1505,Middle Gila,49607,11954,37653,35642,67000833,67086082,44.6463,10.7586,33.8877,32.0778
1993,1506,Salt,268935,161452,107483,35477,54382406,54686818,242.0415,145.3068,96.7347,31.9293
1993,1507,Lower Gila,308449,49034,259415,33608,60109833,60451890,277.6041,44.1306,233.4735,30.2472
1994,1401,Colorado Headwaters,229789,170180,59609,43323,42473210,42746322,206.8101,153.162,53.6481,38.9907
1994,1402,Gunnison,141043,104490,36553,11596,34230603,34383242,126.9387,94.041,32.8977,10.4364
1994,1403,Upper Colorado-Dolores,98205,66869,31336,10404,35614174,35722783,88.3845,60.1821,28.2024,9.3636
1994,1404,Great Divide-Upper Green,641774,491910,149864,92148,92511257,93245179,577.5966,442.719,134.8776,82.9332
1994,1405,White-Yampa,114852,47258,67594,37509,58190135,58342496,103.3668,42.5322,60.8346,33.7581
1994,1406,Lower Green,372093,258734,113359,112428,62867553,63352074,334.8837,232.8606,102.0231,101.1852
1994,1407,Upper Colorado-Dirty Devil,799391,710416,88975,88318,56798249,57685958,719.4519,639.3744,80.0775,79.4862
1994,1408,San Juan,322645,234360,88285,73997,103932166,104328808,290.3805,210.924,79.4565,66.5973
1994,1501,Lower Colorado-Lake Mead,987567,871486,116081,112917,125395858,126496342,888.8103,784.3374,104.4729,101.6253
1994,1502,Little Colorado,171776,66440,105336,103131,110769840,111044747,154.5984,59.796,94.8024,92.8179
1994,1503,Lower Colorado,437063,385947,51116,71601,69304453,69813117,393.3567,347.3523,46.0044,64.4409
1994,1504,Upper Gila,105924,52316,53608,41752,60550801,60698477,95.3316,47.0844,48.2472,37.5768
1994,1505,Middle Gila,44745,10592,34153,40490,67000847,67086082,40.2705,9.5328,30.7377,36.441
1994,1506,Salt,221866,142423,79443,82285,54382667,54686818,199.6794,128.1807,71.4987,74.0565
1994,1507,Lower Gila,97380,45023,52357,244962,60109548,60451890,87.642,40.5207,47.1213,220.4658
1995,1401,Colorado Headwaters,247872,187840,60032,25026,42473424,42746322,223.0848,169.056,54.0288,22.5234
1995,1402,Gunnison,145858,107802,38056,6755,34230629,34383242,131.2722,97.0218,34.2504,6.0795
1995,1403,Upper Colorado-Dolores,102004,73407,28597,6629,35614150,35722783,91.8036,66.0663,25.7373,5.9661
1995,1404,Great Divide-Upper Green,674683,523206,151477,56845,92513651,93245179,607.2147,470.8854,136.3293,51.1605
1995,1405,White-Yampa,123872,62773,61099,28360,58190264,58342496,111.4848,56.4957,54.9891,25.524
1995,1406,Lower Green,407695,299604,108091,76743,62867636,63352074,366.9255,269.6436,97.2819,69.0687
1995,1407,Upper Colorado-Dirty Devil,875059,691450,183609,12561,56798338,57685958,787.5531,622.305,165.2481,11.3049
1995,1408,San Juan,344302,246342,97960,52338,103932168,104328808,309.8718,221.7078,88.164,47.1042
1995,1501,Lower Colorado-Lake Mead,984159,882690,101469,116303,125395880,126496342,885.7431,794.421,91.3221,104.6727
1995,1502,Little Colorado,200159,76162,123997,74753,110769835,111044747,180.1431,68.5458,111.5973,67.2777
1995,1503,Lower Colorado,459166,391550,67616,49481,69304470,69813117,413.2494,352.395,60.8544,44.5329
1995,1504,Upper Gila,127536,82319,45217,20199,60550742,60698477,114.7824,74.0871,40.6953,18.1791
1995,1505,Middle Gila,50527,11661,38866,34715,67000840,67086082,45.4743,10.4949,34.9794,31.2435
1995,1506,Salt,268075,158173,109902,36345,54382398,54686818,241.2675,142.3557,98.9118,32.7105
1995,1507,Lower Gila,245974,40374,205600,96406,60109510,60451890,221.3766,36.3366,185.04,86.7654
1996,1401,Colorado Headwaters,251465,186105,65360,21999,42472858,42746322,226.3185,167.4945,58.824,19.7991
1996,1402,Gunnison,144518,104616,39902,8163,34230561,34383242,130.0662,94.1544,35.9118,7.3467
1996,1403,Upper Colorado-Dolores,97631,66104,31527,11015,35614137,35722783,87.8679,59.4936,28.3743,9.9135
1996,1404,Great Divide-Upper Green,666944,524372,142572,66868,92511367,93245179,600.2496,471.9348,128.3148,60.1812
1996,1405,White-Yampa,118507,56347,62160,33785,58190204,58342496,106.6563,50.7123,55.944,30.4065
1996,1406,Lower Green,416711,299414,117297,67960,62867403,63352074,375.0399,269.4726,105.5673,61.164
1996,1407,Upper Colorado-Dirty Devil,861877,773076,88801,25824,56798257,57685958,775.6893,695.7684,79.9209,23.2416
1996,1408,San Juan,324031,227711,96320,72504,103932273,104328808,291.6279,204.9399,86.688,65.2536
1996,1501,Lower Colorado-Lake Mead,993170,907699,85471,107309,125395863,126496342,893.853,816.9291,76.9239,96.5781
1996,1502,Little Colorado,133801,39049,94752,141118,110769828,111044747,120.4209,35.1441,85.2768,127.0062
1996,1503,Lower Colorado,437176,384155,53021,71520,69304421,69813117,393.4584,345.7395,47.7189,64.368
1996,1504,Upper Gila,103149,43340,59809,44434,60550894,60698477,92.8341,39.006,53.8281,39.9906
1996,1505,Middle Gila,51021,12313,38708,34251,67000810,67086082,45.9189,11.0817,34.8372,30.8259
1996,1506,Salt,203809,118013,85796,100608,54382401,54686818,183.4281,106.2117,77.2164,90.5472
1996,1507,Lower Gila,65684,43065,22619,276588,60109618,60451890,59.1156,38.7585,20.3571,248.9292
1997,1401,Colorado Headwaters,254843,190455,64388,18382,42473097,42746322,229.3587,171.4095,57.9492,16.5438
1997,1402,Gunnison,145407,106252,39155,7204,34230631,34383242,130.8663,95.6268,35.2395,6.4836
1997,1403,Upper Colorado-Dolores,102739,73825,28914,5874,35614170,35722783,92.4651,66.4425,26.0226,5.2866
1997,1404,Great Divide-Upper Green,695856,532544,163312,37226,92512097,93245179,626.2704,479.2896,146.9808,33.5034
1997,1405,White-Yampa,129054,63131,65923,23229,58190213,58342496,116.1486,56.8179,59.3307,20.9061
1997,1406,Lower Green,447829,328728,119101,36744,62867501,63352074,403.0461,295.8552,107.1909,33.0696
1997,1407,Upper Colorado-Dirty Devil,877607,759963,117644,10080,56798271,57685958,789.8463,683.9667,105.8796,9.072
1997,1408,San Juan,343276,239998,103278,53329,103932203,104328808,308.9484,215.9982,92.9502,47.9961
1997,1501,Lower Colorado-Lake Mead,1044447,944496,99951,56037,125395858,126496342,940.0023,850.0464,89.9559,50.4333
1997,1502,Little Colorado,154339,42606,111733,120586,110769822,111044747,138.9051,38.3454,100.5597,108.5274
1997,1503,Lower Colorado,439403,384526,54877,69337,69304377,69813117,395.4627,346.0734,49.3893,62.4033
1997,1504,Upper Gila,77784,29713,48071,69939,60550754,60698477,70.0056,26.7417,43.2639,62.9451
1997,1505,Middle Gila,48660,8883,39777,36613,67000809,67086082,43.794,7.9947,35.7993,32.9517
1997,1506,Salt,200586,109719,90867,103790,54382442,54686818,180.5274,98.7471,81.7803,93.411
1997,1507,Lower Gila,91169,34567,56602,251268,60109453,60451890,82.0521,31.1103,50.9418,226.1412
1998,1401,Colorado Headwaters,251211,190205,61006,22262,42472849,42746322,226.0899,171.1845,54.9054,20.0358
1998,1402,Gunnison,143582,105164,38418,9088,34230572,34383242,129.2238,94.6476,34.5762,8.1792
1998,1403,Upper Colorado-Dolores,101355,72151,29204,7182,35614246,35722783,91.2195,64.9359,26.2836,6.4638
1998,1404,Great Divide-Upper Green,687266,539076,148190,46464,92511449,93245179,618.5394,485.1684,133.371,41.8176
1998,1405,White-Yampa,122479,61181,61298,29680,58190337,58342496,110.2311,55.0629,55.1682,26.712
1998,1406,Lower Green,422989,327270,95719,61694,62867391,63352074,380.6901,294.543,86.1471,55.5246
1998,1407,Upper Colorado-Dirty Devil,881106,787988,93118,6575,56798277,57685958,792.9954,709.1892,83.8062,5.9175
1998,1408,San Juan,354315,249203,105112,42180,103932313,104328808,318.8835,224.2827,94.6008,37.962
1998,1501,Lower Colorado-Lake Mead,1059477,989900,69577,40898,125395967,126496342,953.5293,890.91,62.6193,36.8082
1998,1502,Little Colorado,189269,55452,133817,85631,110769847,111044747,170.3421,49.9068,120.4353,77.0679
1998,1503,Lower Colorado,450959,392476,58483,57603,69304555,69813117,405.8631,353.2284,52.6347,51.8427
1998,1504,Upper Gila,86811,35557,51254,60906,60550760,60698477,78.1299,32.0013,46.1286,54.8154
1998,1505,Middle Gila,52748,12483,40265,32515,67000819,67086082,47.4732,11.2347,36.2385,29.2635
1998,1506,Salt,238282,145906,92376,66076,54382460,54686818,214.4538,131.3154,83.1384,59.4684
1998,1507,Lower Gila,76235,46789,29446,266149,60109506,60451890,68.6115,42.1101,26.5014,239.5341
1999,1401,Colorado Headwaters,249814,191338,58476,23808,42472700,42746322,224.8326,172.2042,52.6284,21.4272
1999,1402,Gunnison,144119,107175,36944,8595,34230528,34383242,129.7071,96.4575,33.2496,7.7355
1999,1403,Upper Colorado-Dolores,99266,69664,29602,9371,35614146,35722783,89.3394,62.6976,26.6418,8.4339
1999,1404,Great Divide-Upper Green,678661,543928,134733,55212,92511306,93245179,610.7949,489.5352,121.2597,49.6908
1999,1405,White-Yampa,122384,63503,58881,29881,58190231,58342496,110.1456,57.1527,52.9929,26.8929
1999,1406,Lower Green,433954,328497,105457,50652,62867468,63352074,390.5586,295.6473,94.9113,45.5868
1999,1407,Upper Colorado-Dirty Devil,879037,796319,82718,8667,56798254,57685958,791.1333,716.6871,74.4462,7.8003
1999,1408,San Juan,348804,252233,96571,47857,103932147,104328808,313.9236,227.0097,86.9139,43.0713
1999,1501,Lower Colorado-Lake Mead,1055999,984376,71623,44440,125395903,126496342,950.3991,885.9384,64.4607,39.996
1999,1502,Little Colorado,147588,49104,98484,127305,110769854,111044747,132.8292,44.1936,88.6356,114.5745
1999,1503,Lower Colorado,445129,395040,50089,63568,69304420,69813117,400.6161,355.536,45.0801,57.2112
1999,1504,Upper Gila,64686,26264,38422,83046,60550745,60698477,58.2174,23.6376,34.5798,74.7414
1999,1505,Middle Gila,51110,12960,38150,34163,67000809,67086082,45.999,11.664,34.335,30.7467
1999,1506,Salt,192743,129989,62754,111605,54382470,54686818,173.4687,116.9901,56.4786,100.4445
1999,1507,Lower Gila,72424,46823,25601,270013,60109453,60451890,65.1816,42.1407,23.0409,243.0117
2000,1401,Colorado Headwaters,248745,188550,60195,25199,42472378,42746322,223.8705,169.695,54.1755,22.6791
2000,1402,Gunnison,141803,105398,36405,10918,34230521,34383242,127.6227,94.8582,32.7645,9.8262
2000,1403,Upper Colorado-Dolores,98186,68070,30116,10465,35614132,35722783,88.3674,61.263,27.1044,9.4185
2000,1404,Great Divide-Upper Green,654978,509273,145705,79325,92510876,93245179,589.4802,458.3457,131.1345,71.3925
2000,1405,White-Yampa,126559,57316,69243,25845,58190092,58342496,113.9031,51.5844,62.3187,23.2605
2000,1406,Lower Green,410566,306572,103994,74163,62867345,63352074,369.5094,275.9148,93.5946,66.7467
2000,1407,Upper Colorado-Dirty Devil,860986,799164,61822,26728,56798244,57685958,774.8874,719.2476,55.6398,24.0552
2000,1408,San Juan,335489,241287,94202,61174,103932145,104328808,301.9401,217.1583,84.7818,55.0566
2000,1501,Lower Colorado-Lake Mead,1058972,965657,93315,41479,125395891,126496342,953.0748,869.0913,83.9835,37.3311
2000,1502,Little Colorado,134181,34007,100174,140774,110769792,111044747,120.7629,30.6063,90.1566,126.6966
2000,1503,Lower Colorado,447535,398903,48632,61186,69304396,69813117,402.7815,359.0127,43.7688,55.0674
2000,1504,Upper Gila,79575,23577,55998,68181,60550721,60698477,71.6175,21.2193,50.3982,61.3629
2000,1505,Middle Gila,53205,11989,41216,32065,67000812,67086082,47.8845,10.7901,37.0944,28.8585
2000,1506,Salt,184387,108388,75999,120051,54382380,54686818,165.9483,97.5492,68.3991,108.0459
2000,1507,Lower Gila,95554,38789,56765,246885,60109451,60451890,85.9986,34.9101,51.0885,222.1965
2001,1401,Colorado Headwaters,241505,181100,60405,32467,42472350,42746322,217.3545,162.99,54.3645,29.2203
2001,1402,Gunnison,139820,104054,35766,12910,34230512,34383242,125.838,93.6486,32.1894,11.619
2001,1403,Upper Colorado-Dolores,98134,66563,31571,10517,35614132,35722783,88.3206,59.9067,28.4139,9.4653
2001,1404,Great Divide-Upper Green,635395,502678,132717,98895,92510889,93245179,571.8555,452.4102,119.4453,89.0055
2001,1405,White-Yampa,123392,57109,66283,28993,58190111,58342496,111.0528,51.3981,59.6547,26.0937
2001,1406,Lower Green,414866,302605,112261,69853,62867355,63352074,373.3794,272.3445,101.0349,62.8677
2001,1407,Upper Colorado-Dirty Devil,832863,764940,67923,54853,56798242,57685958,749.5767,688.446,61.1307,49.3677
2001,1408,San Juan,328749,237052,91697,67917,103932142,104328808,295.8741,213.3468,82.5273,61.1253
2001,1501,Lower Colorado-Lake Mead,1026095,898949,127146,74420,125395827,126496342,923.4855,809.0541,114.4314,66.978
2001,1502,Little Colorado,150310,37556,112754,124641,110769796,111044747,135.279,33.8004,101.4786,112.1769
2001,1503,Lower Colorado,451705,396696,55009,57042,69304370,69813117,406.5345,357.0264,49.5081,51.3378
2001,1504,Upper Gila,82230,36496,45734,65527,60550720,60698477,74.007,32.8464,41.1606,58.9743
2001,1505,Middle Gila,45415,12394,33021,39867,67000800,67086082,40.8735,11.1546,29.7189,35.8803
2001,1506,Salt,203491,125677,77814,100944,54382383,54686818,183.1419,113.1093,70.0326,90.8496
2001,1507,Lower Gila,73826,44604,29222,268605,60109459,60451890,66.4434,40.1436,26.2998,241.7445
2002,1401,Colorado Headwaters,210137,153084,57053,63820,42472365,42746322,189.1233,137.7756,51.3477,57.438
2002,1402,Gunnison,129719,85346,44373,22998,34230525,34383242,116.7471,76.8114,39.9357,20.6982
2002,1403,Upper Colorado-Dolores,83735,54026,29709,24888,35614160,35722783,75.3615,48.6234,26.7381,22.3992
2002,1404,Great Divide-Upper Green,613341,478698,134643,120819,92511019,93245179,552.0069,430.8282,121.1787,108.7371
2002,1405,White-Yampa,116877,48191,68686,35499,58190120,58342496,105.1893,43.3719,61.8174,31.9491
2002,1406,Lower Green,384797,274392,110405,99905,62867372,63352074,346.3173,246.9528,99.3645,89.9145
2002,1407,Upper Colorado-Dirty Devil,767948,650603,117345,119771,56798239,57685958,691.1532,585.5427,105.6105,107.7939
2002,1408,San Juan,295708,178068,117640,100953,103932147,104328808,266.1372,160.2612,105.876,90.8577
2002,1501,Lower Colorado-Lake Mead,957611,803551,154060,142905,125395826,126496342,861.8499,723.1959,138.654,128.6145
2002,1502,Little Colorado,104288,28349,75939,170667,110769792,111044747,93.8592,25.5141,68.3451,153.6003
2002,1503,Lower Colorado,447120,392978,54142,61641,69304356,69813117,402.408,353.6802,48.7278,55.4769
2002,1504,Upper Gila,57512,28714,28798,90236,60550729,60698477,51.7608,25.8426,25.9182,81.2124
2002,1505,Middle Gila,42785,11788,30997,42497,67000800,67086082,38.5065,10.6092,27.8973,38.2473
2002,1506,Salt,159067,90547,68520,145366,54382385,54686818,143.1603,81.4923,61.668,130.8294
2002,1507,Lower Gila,105090,41765,63325,237344,60109456,60451890,94.581,37.5885,56.9925,213.6096
2003,1401,Colorado Headwaters,242852,177222,65630,31075,42472395,42746322,218.5668,159.4998,59.067,27.9675
2003,1402,Gunnison,132341,92656,39685,20368,34230533,34383242,119.1069,83.3904,35.7165,18.3312
2003,1403,Upper Colorado-Dolores,88397,53497,34900,20256,35614130,35722783,79.5573,48.1473,31.41,18.2304
2003,1404,Great Divide-Upper Green,605922,474308,131614,128268,92510989,93245179,545.3298,426.8772,118.4526,115.4412
2003,1405,White-Yampa,124010,52562,71448,28363,58190123,58342496,111.609,47.3058,64.3032,25.5267
2003,1406,Lower Green,403715,275855,127860,81005,62867354,63352074,363.3435,248.2695,115.074,72.9045
2003,1407,Upper Colorado-Dirty Devil,667447,564371,103076,220267,56798244,57685958,600.7023,507.9339,92.7684,198.2403
2003,1408,San Juan,267106,164667,102439,129556,103932146,104328808,240.3954,148.2003,92.1951,116.6004
2003,1501,Lower Colorado-Lake Mead,878715,749144,129571,221778,125395849,126496342,790.8435,674.2296,116.6139,199.6002
2003,1502,Little Colorado,139995,33268,106727,134961,110769791,111044747,125.9955,29.9412,96.0543,121.4649
2003,1503,Lower Colorado,443530,386838,56692,65231,69304356,69813117,399.177,348.1542,51.0228,58.7079
2003,1504,Upper Gila,55603,22492,33111,92134,60550740,60698477,50.0427,20.2428,29.7999,82.9206
2003,1505,Middle Gila,44329,11812,32517,40950,67000803,67086082,39.8961,10.6308,29.2653,36.855
2003,1506,Salt,191553,119032,72521,112883,54382382,54686818,172.3977,107.1288,65.2689,101.5947
2003,1507,Lower Gila,76794,43556,33238,265637,60109459,60451890,69.1146,39.2004,29.9142,239.0733
2004,1401,Colorado Headwaters,234541,174596,59945,39309,42472472,42746322,211.0869,157.1364,53.9505,35.3781
2004,1402,Gunnison,139934,102089,37845,12800,34230508,34383242,125.9406,91.8801,34.0605,11.52
2004,1403,Upper Colorado-Dolores,92785,59313,33472,15866,35614132,35722783,83.5065,53.3817,30.1248,14.2794
2004,1404,Great Divide-Upper Green,632368,487008,145360,101678,92511133,93245179,569.1312,438.3072,130.824,91.5102
2004,1405,White-Yampa,121815,57526,64289,30583,58190098,58342496,109.6335,51.7734,57.8601,27.5247
2004,1406,Lower Green,390820,284741,106079,93900,62867354,63352074,351.738,256.2669,95.4711,84.51
2004,1407,Upper Colorado-Dirty Devil,586125,494759,91366,301587,56798246,57685958,527.5125,445.2831,82.2294,271.4283
2004,1408,San Juan,272476,167784,104692,124185,103932147,104328808,245.2284,151.0056,94.2228,111.7665
2004,1501,Lower Colorado-Lake Mead,850080,714457,135623,250437,125395825,126496342,765.072,643.0113,122.0607,225.3933
2004,1502,Little Colorado,128974,31571,97403,145973,110769800,111044747,116.0766,28.4139,87.6627,131.3757
2004,1503,Lower Colorado,457876,387307,70569,50884,69304357,69813117,412.0884,348.5763,63.5121,45.7956
2004,1504,Upper Gila,57518,22060,35458,90231,60550728,60698477,51.7662,19.854,31.9122,81.2079
2004,1505,Middle Gila,46631,12650,33981,38651,67000800,67086082,41.9679,11.385,30.5829,34.7859
2004,1506,Salt,192527,123817,68710,111912,54382379,54686818,173.2743,111.4353,61.839,100.7208
2004,1507,Lower Gila,101673,44615,57058,240761,60109456,60451890,91.5057,40.1535,51.3522,216.6849
2005,1401,Colorado Headwaters,248781,183997,64784,25135,42472406,42746322,223.9029,165.5973,58.3056,22.6215
2005,1402,Gunnison,142893,103246,39647,9837,34230512,34383242,128.6037,92.9214,35.6823,8.8533
2005,1403,Upper Colorado-Dolores,101502,66113,35389,7149,35614132,35722783,91.3518,59.5017,31.8501,6.4341
2005,1404,Great Divide-Upper Green,665550,514853,150697,68721,92510908,93245179,598.995,463.3677,135.6273,61.8489
2005,1405,White-Yampa,130850,60627,70223,21547,58190099,58342496,117.765,54.5643,63.2007,19.3923
2005,1406,Lower Green,438506,304445,134061,46214,62867354,63352074,394.6554,274.0005,120.6549,41.5926
2005,1407,Upper Colorado-Dirty Devil,650013,478499,171514,237670,56798275,57685958,585.0117,430.6491,154.3626,213.903
2005,1408,San Juan,309331,194377,114954,87334,103932143,104328808,278.3979,174.9393,103.4586,78.6006
2005,1501,Lower Colorado-Lake Mead,866956,756133,110823,233543,125395843,126496342,780.2604,680.5197,99.7407,210.1887
2005,1502,Little Colorado,194192,53871,140321,80764,110769791,111044747,174.7728,48.4839,126.2889,72.6876
2005,1503,Lower Colorado,465020,399696,65324,43747,69304350,69813117,418.518,359.7264,58.7916,39.3723
2005,1504,Upper Gila,100592,50686,49906,47148,60550737,60698477,90.5328,45.6174,44.9154,42.4332
2005,1505,Middle Gila,52550,13171,39379,32719,67000813,67086082,47.295,11.8539,35.4411,29.4471
2005,1506,Salt,282649,181902,100747,21768,54382401,54686818,254.3841,163.7118,90.6723,19.5912
2005,1507,Lower Gila,197589,51144,146445,144648,60109653,60451890,177.8301,46.0296,131.8005,130.1832
2006,1401,Colorado Headwaters,247385,188175,59210,26504,42472433,42746322,222.6465,169.3575,53.289,23.8536
2006,1402,Gunnison,143686,106829,36857,9043,34230513,34383242,129.3174,96.1461,33.1713,8.1387
2006,1403,Upper Colorado-Dolores,96323,63819,32504,12321,35614139,35722783,86.6907,57.4371,29.2536,11.0889
2006,1404,Great Divide-Upper Green,649585,510514,139071,84684,92510910,93245179,584.6265,459.4626,125.1639,76.2156
2006,1405,White-Yampa,130062,59916,70146,22333,58190101,58342496,117.0558,53.9244,63.1314,20.0997
2006,1406,Lower Green,422840,307238,115602,61879,62867355,63352074,380.556,276.5142,104.0418,55.6911
2006,1407,Upper Colorado-Dirty Devil,652804,549545,103259,234916,56798238,57685958,587.5236,494.5905,92.9331,211.4244
2006,1408,San Juan,311827,204043,107784,84845,103932136,104328808,280.6443,183.6387,97.0056,76.3605
2006,1501,Lower Colorado-Lake Mead,862434,722589,139845,238062,125395846,126496342,776.1906,650.3301,125.8605,214.2558
2006,1502,Little Colorado,160818,39413,121405,114130,110769799,111044747,144.7362,35.4717,109.2645,102.717
2006,1503,Lower Colorado,448039,395187,52852,60698,69304380,69813117,403.2351,355.6683,47.5668,54.6282
2006,1504,Upper Gila,90527,35579,54948,57224,60550726,60698477,81.4743,32.0211,49.4532,51.5016
2006,1505,Middle Gila,50622,12350,38272,34659,67000801,67086082,45.5598,11.115,34.4448,31.1931
2006,1506,Salt,221380,158117,63263,83035,54382403,54686818,199.242,142.3053,56.9367,74.7315
2006,1507,Lower Gila,80795,51436,29359,261629,60109466,60451890,72.7155,46.2924,26.4231,235.4661
2007,1401,Colorado Headwaters,244602,185693,58909,29291,42472429,42746322,220.1418,167.1237,53.0181,26.3619
2007,1402,Gunnison,143485,105993,37492,9243,34230514,34383242,129.1365,95.3937,33.7428,8.3187
2007,1403,Upper Colorado-Dolores,96402,65236,31166,12250,35614131,35722783,86.7618,58.7124,28.0494,11.025
2007,1404,Great Divide-Upper Green,637624,509594,128030,96654,92510901,93245179,573.8616,458.6346,115.227,86.9886
2007,1405,White-Yampa,128658,56831,71827,23725,58190113,58342496,115.7922,51.1479,64.6443,21.3525
2007,1406,Lower Green,405583,293319,112264,79133,62867358,63352074,365.0247,263.9871,101.0376,71.2197
2007,1407,Upper Colorado-Dirty Devil,652526,560297,92229,235187,56798245,57685958,587.2734,504.2673,83.0061,211.6683
2007,1408,San Juan,314721,213371,101350,81953,103932134,104328808,283.2489,192.0339,91.215,73.7577
2007,1501,Lower Colorado-Lake Mead,806115,684801,121314,294398,125395829,126496342,725.5035,616.3209,109.1826,264.9582
2007,1502,Little Colorado,144319,34973,109346,130623,110769805,111044747,129.8871,31.4757,98.4114,117.5607
2007,1503,Lower Colorado,440443,392134,48309,68310,69304364,69813117,396.3987,352.9206,43.4781,61.479
2007,1504,Upper Gila,88590,42068,46522,59142,60550745,60698477,79.731,37.8612,41.8698,53.2278
2007,1505,Middle Gila,47919,12900,35019,37335,67000828,67086082,43.1271,11.61,31.5171,33.6015
2007,1506,Salt,207613,139968,67645,96825,54382380,54686818,186.8517,125.9712,60.8805,87.1425
2007,1507,Lower Gila,83206,49121,34085,259230,60109454,60451890,74.8854,44.2089,30.6765,233.307
2008,1401,Colorado Headwaters,255397,191128,64269,18555,42472370,42746322,229.8573,172.0152,57.8421,16.6995
2008,1402,Gunnison,145853,105428,40425,6865,34230524,34383242,131.2677,94.8852,36.3825,6.1785
2008,1403,Upper Colorado-Dolores,98443,67660,30783,10206,35614134,35722783,88.5987,60.894,27.7047,9.1854
2008,1404,Great Divide-Upper Green,644936,508445,136491,89242,92511001,93245179,580.4424,457.6005,122.8419,80.3178
2008,1405,White-Yampa,136270,66664,69606,16098,58190128,58342496,122.643,59.9976,62.6454,14.4882
2008,1406,Lower Green,420093,307551,112542,64583,62867398,63352074,378.0837,276.7959,101.2878,58.1247
2008,1407,Upper Colorado-Dirty Devil,713580,549077,164503,174139,56798239,57685958,642.222,494.1693,148.0527,156.7251
2008,1408,San Juan,317785,208119,109666,78885,103932138,104328808,286.0065,187.3071,98.6994,70.9965
2008,1501,Lower Colorado-Lake Mead,803970,665777,138193,296545,125395827,126496342,723.573,599.1993,124.3737,266.8905
2008,1502,Little Colorado,204471,59419,145052,70476,110769800,111044747,184.0239,53.4771,130.5468,63.4284
2008,1503,Lower Colorado,447540,392649,54891,61223,69304354,69813117,402.786,353.3841,49.4019,55.1007
2008,1504,Upper Gila,93099,51760,41339,54627,60550751,60698477,83.7891,46.584,37.2051,49.1643
2008,1505,Middle Gila,56133,13885,42248,29147,67000802,67086082,50.5197,12.4965,38.0232,26.2323
2008,1506,Salt,274626,185257,89369,29810,54382382,54686818,247.1634,166.7313,80.4321,26.829
2008,1507,Lower Gila,102505,50735,51770,239938,60109447,60451890,92.2545,45.6615,46.593,215.9442
2009,1401,Colorado Headwaters,250851,188998,61853,23004,42472467,42746322,225.7659,170.0982,55.6677,20.7036
2009,1402,Gunnison,145438,107406,38032,7293,34230511,34383242,130.8942,96.6654,34.2288,6.5637
2009,1403,Upper Colorado-Dolores,97043,65322,31721,11610,35614130,35722783,87.3387,58.7898,28.5489,10.449
2009,1404,Great Divide-Upper Green,669685,525420,144265,64280,92511214,93245179,602.7165,472.878,129.8385,57.852
2009,1405,White-Yampa,132029,66515,65514,20354,58190113,58342496,118.8261,59.8635,58.9626,18.3186
2009,1406,Lower Green,412147,317433,94714,72581,62867346,63352074,370.9323,285.6897,85.2426,65.3229
2009,1407,Upper Colorado-Dirty Devil,738739,602672,136067,148981,56798238,57685958,664.8651,542.4048,122.4603,134.0829
2009,1408,San Juan,304598,208316,96282,92074,103932136,104328808,274.1382,187.4844,86.6538,82.8666
2009,1501,Lower Colorado-Lake Mead,762022,640033,121989,338483,125395837,126496342,685.8198,576.0297,109.7901,304.6347
2009,1502,Little Colorado,148640,43083,105557,126315,110769792,111044747,133.776,38.7747,95.0013,113.6835
2009,1503,Lower Colorado,447187,390994,56193,61576,69304354,69813117,402.4683,351.8946,50.5737,55.4184
2009,1504,Upper Gila,72747,22880,49867,75007,60550723,60698477,65.4723,20.592,44.8803,67.5063
2009,1505,Middle Gila,43454,12852,30602,41827,67000801,67086082,39.1086,11.5668,27.5418,37.6443
2009,1506,Salt,256392,176374,80018,48046,54382380,54686818,230.7528,158.7366,72.0162,43.2414
2009,1507,Lower Gila,87811,49600,38211,254611,60109468,60451890,79.0299,44.64,34.3899,229.1499
2010,1401,Colorado Headwaters,249757,189070,60687,24183,42472382,42746322,224.7813,170.163,54.6183,21.7647
2010,1402,Gunnison,143501,107585,35916,9223,34230518,34383242,129.1509,96.8265,32.3244,8.3007
2010,1403,Upper Colorado-Dolores,98222,66324,31898,10394,35614167,35722783,88.3998,59.6916,28.7082,9.3546
2010,1404,Great Divide-Upper Green,655562,522636,132926,78554,92511063,93245179,590.0058,470.3724,119.6334,70.6986
2010,1405,White-Yampa,128829,65512,63317,23525,58190142,58342496,115.9461,58.9608,56.9853,21.1725
2010,1406,Lower Green,417312,312112,105200,67372,62867390,63352074,375.5808,280.9008,94.68,60.6348
2010,1407,Upper Colorado-Dirty Devil,733983,624105,109878,153718,56798257,57685958,660.5847,561.6945,98.8902,138.3462
2010,1408,San Juan,327147,218456,108691,69505,103932156,104328808,294.4323,196.6104,97.8219,62.5545
2010,1501,Lower Colorado-Lake Mead,763462,624251,139211,337023,125395857,126496342,687.1158,561.8259,125.2899,303.3207
2010,1502,Little Colorado,199684,57933,141751,75262,110769801,111044747,179.7156,52.1397,127.5759,67.7358
2010,1503,Lower Colorado,453698,394216,59482,55063,69304356,69813117,408.3282,354.7944,53.5338,49.5567
2010,1504,Upper Gila,88808,40969,47839,58943,60550726,60698477,79.9272,36.8721,43.0551,53.0487
2010,1505,Middle Gila,56358,16864,39494,28924,67000800,67086082,50.7222,15.1776,35.5446,26.0316
2010,1506,Salt,275382,192513,82869,29044,54382392,54686818,247.8438,173.2617,74.5821,26.1396
2010,1507,Lower Gila,154550,51784,102766,187887,60109453,60451890,139.095,46.6056,92.4894,169.0983
2011,1401,Colorado Headwaters,261909,196135,65774,12039,42472374,42746322,235.7181,176.5215,59.1966,10.8351
2011,1402,Gunnison,145563,107768,37795,7162,34230517,34383242,131.0067,96.9912,34.0155,6.4458
2011,1403,Upper Colorado-Dolores,100149,70198,29951,8503,35614131,35722783,90.1341,63.1782,26.9559,7.6527
2011,1404,Great Divide-Upper Green,684034,533516,150518,50053,92511092,93245179,615.6306,480.1644,135.4662,45.0477
2011,1405,White-Yampa,144017,70443,73574,8350,58190129,58342496,129.6153,63.3987,66.2166,7.515
2011,1406,Lower Green,467675,329533,138142,17011,62867388,63352074,420.9075,296.5797,124.3278,15.3099
2011,1407,Upper Colorado-Dirty Devil,799208,617724,181484,88495,56798255,57685958,719.2872,555.9516,163.3356,79.6455
2011,1408,San Juan,334017,221780,112237,62650,103932141,104328808,300.6153,199.602,101.0133,56.385
2011,1501,Lower Colorado-Lake Mead,788646,656251,132395,311861,125395835,126496342,709.7814,590.6259,119.1555,280.6749
2011,1502,Little Colorado,154898,47944,106954,120058,110769791,111044747,139.4082,43.1496,96.2586,108.0522
2011,1503,Lower Colorado,449844,393260,56584,58910,69304363,69813117,404.8596,353.934,50.9256,53.019
2011,1504,Upper Gila,56433,13656,42777,91316,60550728,60698477,50.7897,12.2904,38.4993,82.1844
2011,1505,Middle Gila,45344,14545,30799,39933,67000805,67086082,40.8096,13.0905,27.7191,35.9397
2011,1506,Salt,243619,168051,75568,60821,54382378,54686818,219.2571,151.2459,68.0112,54.7389
2011,1507,Lower Gila,81874,47237,34637,260554,60109462,60451890,73.6866,42.5133,31.1733,234.4986
2012,1401,Colorado Headwaters,228331,170831,57500,45620,42472371,42746322,205.4979,153.7479,51.75,41.058
2012,1402,Gunnison,130978,91726,39252,21733,34230531,34383242,117.8802,82.5534,35.3268,19.5597
2012,1403,Upper Colorado-Dolores,88930,57190,31740,19706,35614147,35722783,80.037,51.471,28.566,17.7354
2012,1404,Great Divide-Upper Green,633945,501101,132844,99210,92512024,93245179,570.5505,450.9909,119.5596,89.289
2012,1405,White-Yampa,116687,49303,67384,35711,58190098,58342496,105.0183,44.3727,60.6456,32.1399
2012,1406,Lower Green,399120,288968,110152,85459,62867495,63352074,359.208,260.0712,99.1368,76.9131
2012,1407,Upper Colorado-Dirty Devil,720765,631679,89086,166943,56798250,57685958,648.6885,568.5111,80.1774,150.2487
2012,1408,San Juan,289198,187181,102017,107429,103932181,104328808,260.2782,168.4629,91.8153,96.6861
2012,1501,Lower Colorado-Lake Mead,809893,679382,130511,290547,125395902,126496342,728.9037,611.4438,117.4599,261.4923
2012,1502,Little Colorado,104060,34720,69340,170883,110769804,111044747,93.654,31.248,62.406,153.7947
2012,1503,Lower Colorado,432940,382173,50767,75764,69304413,69813117,389.646,343.9557,45.6903,68.1876
2012,1504,Upper Gila,39568,9737,29831,108159,60550750,60698477,35.6112,8.7633,26.8479,97.3431
2012,1505,Middle Gila,40779,11133,29646,44497,67000806,67086082,36.7011,10.0197,26.6814,40.0473
2012,1506,Salt,192860,140151,52709,111539,54382419,54686818,173.574,126.1359,47.4381,100.3851
2012,1507,Lower Gila,73834,47707,26127,268472,60109584,60451890,66.4506,42.9363,23.5143,241.6248
2013,1401,Colorado Headwaters,239475,183645,55830,34490,42472357,42746322,215.5275,165.2805,50.247,31.041
2013,1402,Gunnison,129727,94496,35231,22975,34230540,34383242,116.7543,85.0464,31.7079,20.6775
2013,1403,Upper Colorado-Dolores,83435,54595,28840,25197,35614151,35722783,75.0915,49.1355,25.956,22.6773
2013,1404,Great Divide-Upper Green,615039,489483,125556,119175,92510965,93245179,553.5351,440.5347,113.0004,107.2575
2013,1405,White-Yampa,121451,59004,62447,30914,58190131,58342496,109.3059,53.1036,56.2023,27.8226
2013,1406,Lower Green,382075,287167,94908,102592,62867407,63352074,343.8675,258.4503,85.4172,92.3328
2013,1407,Upper Colorado-Dirty Devil,615087,532562,82525,272633,56798238,57685958,553.5783,479.3058,74.2725,245.3697
2013,1408,San Juan,276179,170971,105208,120460,103932169,104328808,248.5611,153.8739,94.6872,108.414
2013,1501,Lower Colorado-Lake Mead,742652,659137,83515,357842,125395848,126496342,668.3868,593.2233,75.1635,322.0578
2013,1502,Little Colorado,135775,36361,99414,139163,110769809,111044747,122.1975,32.7249,89.4726,125.2467
2013,1503,Lower Colorado,436005,386856,49149,72741,69304371,69813117,392.4045,348.1704,44.2341,65.4669
2013,1504,Upper Gila,54898,9879,45019,92853,60550726,60698477,49.4082,8.8911,40.5171,83.5677
2013,1505,Middle Gila,38630,11710,26920,46620,67000832,67086082,34.767,10.539,24.228,41.958
2013,1506,Salt,196405,144546,51859,108031,54382382,54686818,176.7645,130.0914,46.6731,97.2279
2013,1507,Lower Gila,73713,48339,25374,268720,60109457,60451890,66.3417,43.5051,22.8366,241.848
2014,1401,Colorado Headwaters,256747,193500,63247,17240,42472335,42746322,231.0723,174.15,56.9223,15.516
2014,1402,Gunnison,143236,108691,34545,9485,34230521,34383242,128.9124,97.8219,31.0905,8.5365
2014,1403,Upper Colorado-Dolores,92817,60642,32175,15834,35614132,35722783,83.5353,54.5778,28.9575,14.2506
2014,1404,Great Divide-Upper Green,660512,516517,143995,73776,92510891,93245179,594.4608,464.8653,129.5955,66.3984
2014,1405,White-Yampa,130863,68049,62814,21516,58190117,58342496,117.7767,61.2441,56.5326,19.3644
2014,1406,Lower Green,402720,301280,101440,82012,62867342,63352074,362.448,271.152,91.296,73.8108
2014,1407,Upper Colorado-Dirty Devil,633113,507654,125459,254607,56798238,57685958,569.8017,456.8886,112.9131,229.1463
2014,1408,San Juan,277436,179201,98235,119240,103932132,104328808,249.6924,161.2809,88.4115,107.316
2014,1501,Lower Colorado-Lake Mead,743862,609709,134153,356652,125395828,126496342,669.4758,548.7381,120.7377,320.9868
2014,1502,Little Colorado,122500,29903,92597,152451,110769796,111044747,110.25,26.9127,83.3373,137.2059
2014,1503,Lower Colorado,435539,387544,47995,73227,69304351,69813117,391.9851,348.7896,43.1955,65.9043
2014,1504,Upper Gila,57054,17222,39832,90691,60550732,60698477,51.3486,15.4998,35.8488,81.6219
2014,1505,Middle Gila,44990,12459,32531,40292,67000800,67086082,40.491,11.2131,29.2779,36.2628
2014,1506,Salt,194603,131052,63551,109836,54382379,54686818,175.1427,117.9468,57.1959,98.8524
2014,1507,Lower Gila,76559,50822,25737,265752,60109579,60451890,68.9031,45.7398,23.1633,239.1768
2015,1401,Colorado Headwaters,254863,181192,73671,24940,42466519,42746322,229.3767,163.0728,66.3039,22.446
2015,1402,Gunnison,144537,103611,40926,11445,34227260,34383242,130.0833,93.2499,36.8334,10.3005
2015,1403,Upper Colorado-Dolores,95283,61972,33311,15418,35612082,35722783,85.7547,55.7748,29.9799,13.8762
2015,1404,Great Divide-Upper Green,671072,530988,140084,114475,92459632,93245179,603.9648,477.8892,126.0756,103.0275
2015,1405,White-Yampa,126599,63057,63542,29573,58186324,58342496,113.9391,56.7513,57.1878,26.6157
2015,1406,Lower Green,398877,303402,95475,95387,62857810,63352074,358.9893,273.0618,85.9275,85.8483
2015,1407,Upper Colorado-Dirty Devil,655105,539631,115474,236909,56793944,57685958,589.5945,485.6679,103.9266,213.2181
2015,1408,San Juan,299918,193437,106481,103211,103925679,104328808,269.9262,174.0933,95.8329,92.8899
2015,1501,Lower Colorado-Lake Mead,723258,596549,126709,384493,125388591,126496342,650.9322,536.8941,114.0381,346.0437
2015,1502,Little Colorado,135663,32658,103005,144359,110764725,111044747,122.0967,29.3922,92.7045,129.9231
2015,1503,Lower Colorado,438350,386574,51776,75519,69299248,69813117,394.515,347.9166,46.5984,67.9671
2015,1504,Upper Gila,63985,21772,42213,88700,60545792,60698477,57.5865,19.5948,37.9917,79.83
2015,1505,Middle Gila,48045,13988,34057,72320,66965717,67086082,43.2405,12.5892,30.6513,65.088
2015,1506,Salt,205744,139175,66569,106138,54374936,54686818,185.1696,125.2575,59.9121,95.5242
2015,1507,Lower Gila,79184,51728,27456,265198,60107508,60451890,71.2656,46.5552,24.7104,238.6782
2016,1401,Colorado Headwaters,258787,183715,75072,21147,42466388,42746322,232.9083,165.3435,67.5648,19.0323
2016,1402,Gunnison,148710,103501,45209,7350,34227182,34383242,133.839,93.1509,40.6881,6.615
2016,1403,Upper Colorado-Dolores,98311,67166,31145,12416,35612056,35722783,88.4799,60.4494,28.0305,11.1744
2016,1404,Great Divide-Upper Green,712639,532450,180189,72511,92460029,93245179,641.3751,479.205,162.1701,65.2599
2016,1405,White-Yampa,136054,61845,74209,20153,58186289,58342496,122.4486,55.6605,66.7881,18.1377
2016,1406,Lower Green,422267,301990,120277,71898,62857909,63352074,380.0403,271.791,108.2493,64.7082
2016,1407,Upper Colorado-Dirty Devil,668516,544344,124172,223508,56793934,57685958,601.6644,489.9096,111.7548,201.1572
2016,1408,San Juan,308279,211382,96897,94927,103925602,104328808,277.4511,190.2438,87.2073,85.4343
2016,1501,Lower Colorado-Lake Mead,690185,591884,98301,417566,125388591,126496342,621.1665,532.6956,88.4709,375.8094
2016,1502,Little Colorado,132372,29895,102477,147674,110764701,111044747,119.1348,26.9055,92.2293,132.9066
2016,1503,Lower Colorado,432930,383182,49748,80940,69299247,69813117,389.637,344.8638,44.7732,72.846
2016,1504,Upper Gila,63124,20292,42832,89557,60545796,60698477,56.8116,18.2628,38.5488,80.6013
2016,1505,Middle Gila,73496,15136,58360,46910,66965676,67086082,66.1464,13.6224,52.524,42.219
2016,1506,Salt,203203,129522,73681,108681,54374934,54686818,182.8827,116.5698,66.3129,97.8129
2016,1507,Lower Gila,89547,51316,38231,254838,60107505,60451890,80.5923,46.1844,34.4079,229.3542
2017,1401,Colorado Headwaters,259158,183298,75860,21280,42465884,42746322,233.2422,164.9682,68.274,19.152
2017,1402,Gunnison,150542,105307,45235,5722,34226978,34383242,135.4878,94.7763,40.7115,5.1498
2017,1403,Upper Colorado-Dolores,98426,68557,29869,12321,35612036,35722783,88.5834,61.7013,26.8821,11.0889
2017,1404,Great Divide-Upper Green,758706,543161,215545,29657,92456816,93245179,682.8354,488.8449,193.9905,26.6913
2017,1405,White-Yampa,133744,64611,69133,22693,58186059,58342496,120.3696,58.1499,62.2197,20.4237
2017,1406,Lower Green,432447,320074,112373,62839,62856788,63352074,389.2023,288.0666,101.1357,56.5551
2017,1407,Upper Colorado-Dirty Devil,704916,561831,143085,187349,56793693,57685958,634.4244,505.6479,128.7765,168.6141
2017,1408,San Juan,314503,217474,97029,88781,103925524,104328808,283.0527,195.7266,87.3261,79.9029
2017,1501,Lower Colorado-Lake Mead,705341,609303,96038,402417,125388584,126496342,634.8069,548.3727,86.4342,362.1753
2017,1502,Little Colorado,165869,46024,119845,114174,110764704,111044747,149.2821,41.4216,107.8605,102.7566
2017,1503,Lower Colorado,447343,393164,54179,66522,69299252,69813117,402.6087,353.8476,48.7611,59.8698
2017,1504,Upper Gila,75430,32496,42934,77259,60545788,60698477,67.887,29.2464,38.6406,69.5331
2017,1505,Middle Gila,72714,13625,59089,47692,66965676,67086082,65.4426,12.2625,53.1801,42.9228
2017,1506,Salt,254225,162464,91761,57655,54374938,54686818,228.8025,146.2176,82.5849,51.8895
2017,1507,Lower Gila,87209,51774,35435,257174,60107507,60451890,78.4881,46.5966,31.8915,231.4566
2018,1401,Colorado Headwaters,251897,172526,79371,28348,42466077,42746322,226.7073,155.2734,71.4339,25.5132
2018,1402,Gunnison,137743,87916,49827,18501,34226998,34383242,123.9687,79.1244,44.8443,16.6509
2018,1403,Upper Colorado-Dolores,87011,53368,33643,23725,35612047,35722783,78.3099,48.0312,30.2787,21.3525
2018,1404,Great Divide-Upper Green,694075,526946,167129,93500,92457604,93245179,624.6675,474.2514,150.4161,84.15
2018,1405,White-Yampa,125804,54053,71751,30590,58186102,58342496,113.2236,48.6477,64.5759,27.531
2018,1406,Lower Green,402815,295271,107544,92004,62857255,63352074,362.5335,265.7439,96.7896,82.8036
2018,1407,Upper Colorado-Dirty Devil,649348,549231,100117,242911,56793699,57685958,584.4132,494.3079,90.1053,218.6199
2018,1408,San Juan,271233,172818,98415,132039,103925536,104328808,244.1097,155.5362,88.5735,118.8351
2018,1501,Lower Colorado-Lake Mead,702203,597505,104698,405560,125388579,126496342,631.9827,537.7545,94.2282,365.004
2018,1502,Little Colorado,100693,30961,69732,179352,110764702,111044747,90.6237,27.8649,62.7588,161.4168
2018,1503,Lower Colorado,439836,385875,53961,74029,69299252,69813117,395.8524,347.2875,48.5649,66.6261
2018,1504,Upper Gila,49678,12425,37253,102999,60545800,60698477,44.7102,11.1825,33.5277,92.6991
2018,1505,Middle Gila,73858,14467,59391,46545,66965679,67086082,66.4722,13.0203,53.4519,41.8905
2018,1506,Salt,196236,133452,62784,115648,54374934,54686818,176.6124,120.1068,56.5056,104.0832
2018,1507,Lower Gila,85865,50958,34907,258516,60107509,60451890,77.2785,45.8622,31.4163,232.6644
2019,1401,Colorado Headwaters,260054,181059,78995,21140,42465128,42746322,234.0486,162.9531,71.0955,19.026
2019,1402,Gunnison,150492,95335,55157,6092,34226658,34383242,135.4428,85.8015,49.6413,5.4828
2019,1403,Upper Colorado-Dolores,100561,66632,33929,10705,35611517,35722783,90.5049,59.9688,30.5361,9.6345
2019,1404,Great Divide-Upper Green,706599,536864,169735,82008,92456572,93245179,635.9391,483.1776,152.7615,73.8072
2019,1405,White-Yampa,137645,62471,75174,20778,58184073,58342496,123.8805,56.2239,67.6566,18.7002
2019,1406,Lower Green,443353,312790,130563,53176,62855545,63352074,399.0177,281.511,117.5067,47.8584
2019,1407,Upper Colorado-Dirty Devil,663086,501747,161339,230394,56792478,57685958,596.7774,451.5723,145.2051,207.3546
2019,1408,San Juan,304055,192944,111111,101177,103923576,104328808,273.6495,173.6496,99.9999,91.0593
2019,1501,Lower Colorado-Lake Mead,705456,618584,86872,404300,125386586,126496342,634.9104,556.7256,78.1848,363.87
2019,1502,Little Colorado,177692,47997,129695,105395,110761660,111044747,159.9228,43.1973,116.7255,94.8555
2019,1503,Lower Colorado,444706,393146,51560,70798,69297613,69813117,400.2354,353.8314,46.404,63.7182
2019,1504,Upper Gila,69660,21197,48463,84138,60544679,60698477,62.694,19.0773,43.6167,75.7242
2019,1505,Middle Gila,69975,13981,55994,52320,66963787,67086082,62.9775,12.5829,50.3946,47.088
2019,1506,Salt,261997,165710,96287,51599,54373222,54686818,235.7973,149.139,86.6583,46.4391
2019,1507,Lower Gila,88134,51922,36212,256828,60106928,60451890,79.3206,46.7298,32.5908,231.1452
2020,1401,Colorado Headwaters,281925,177393,104532,26169,42438228,42746322,253.7325,159.6537,94.0788,23.5521
2020,1402,Gunnison,144805,90916,53889,15513,34222924,34383242,130.3245,81.8244,48.5001,13.9617
2020,1403,Upper Colorado-Dolores,96805,56086,40719,20473,35605505,35722783,87.1245,50.4774,36.6471,18.4257
2020,1404,Great Divide-Upper Green,716328,522045,194283,106902,92421949,93245179,644.6952,469.8405,174.8547,96.2118
2020,1405,White-Yampa,135853,55730,80123,25669,58180974,58342496,122.2677,50.157,72.1107,23.1021
2020,1406,Lower Green,417137,296862,120275,86089,62848848,63352074,375.4233,267.1758,108.2475,77.4801
2020,1407,Upper Colorado-Dirty Devil,647649,550329,97320,257787,56780522,57685958,582.8841,495.2961,87.588,232.0083
2020,1408,San Juan,288963,193963,95000,122538,103917307,104328808,260.0667,174.5667,85.5,110.2842
2020,1501,Lower Colorado-Lake Mead,765156,615331,149825,397768,125333418,126496342,688.6404,553.7979,134.8425,357.9912
2020,1502,Little Colorado,133231,40162,93069,156535,110754981,111044747,119.9079,36.1458,83.7621,140.8815
2020,1503,Lower Colorado,452490,395205,57285,65889,69294738,69813117,407.241,355.6845,51.5565,59.3001
2020,1504,Upper Gila,76817,25602,51215,79934,60541726,60698477,69.1353,23.0418,46.0935,71.9406
2020,1505,Middle Gila,64552,13429,51123,60536,66960994,67086082,58.0968,12.0861,46.0107,54.4824
2020,1506,Salt,258282,176259,82023,57906,54370630,54686818,232.4538,158.6331,73.8207,52.1154
2020,1507,Lower Gila,80681,52855,27826,265807,60105402,60451890,72.6129,47.5695,25.0434,239.2263
2021,1401,Colorado Headwaters,268046,174310,93736,41519,42436757,42746322,241.2414,156.879,84.3624,37.3671
2021,1402,Gunnison,132789,84125,48664,28253,34222200,34383242,119.5101,75.7125,43.7976,25.4277
2021,1403,Upper Colorado-Dolores,86649,53671,32978,31208,35604926,35722783,77.9841,48.3039,29.6802,28.0872
2021,1404,Great Divide-Upper Green,661521,497178,164343,161008,92422650,93245179,595.3689,447.4602,147.9087,144.9072
2021,1405,White-Yampa,123169,52592,70577,38973,58180354,58342496,110.8521,47.3328,63.5193,35.0757
2021,1406,Lower Green,391285,280196,111089,113308,62847481,63352074,352.1565,252.1764,99.9801,101.9772
2021,1407,Upper Colorado-Dirty Devil,544477,429042,115435,361436,56780045,57685958,490.0293,386.1378,103.8915,325.2924
2021,1408,San Juan,263618,159473,104145,148637,103916553,104328808,237.2562,143.5257,93.7305,133.7733
2021,1501,Lower Colorado-Lake Mead,746897,579403,167494,418082,125331363,126496342,672.2073,521.4627,150.7446,376.2738
2021,1502,Little Colorado,141224,26078,115146,160861,110742662,111044747,127.1016,23.4702,103.6314,144.7749
2021,1503,Lower Colorado,443470,390309,53161,77626,69292021,69813117,399.123,351.2781,47.8449,69.8634
2021,1504,Upper Gila,48195,5667,42528,109598,60540684,60698477,43.3755,5.1003,38.2752,98.6382
2021,1505,Middle Gila,70965,15575,55390,54920,66960197,67086082,63.8685,14.0175,49.851,49.428
2021,1506,Salt,228736,160596,68140,88507,54369575,54686818,205.8624,144.5364,61.326,79.6563
2021,1507,Lower Gila,105664,52778,52886,242384,60103842,60451890,95.0976,47.5002,47.5974,218.1456
